10
10
1 0 4
1 1 1
1 2 1
1 3 1
1 4 1
1 5 1
1 6 1
1 7 1
1 8 1
1 9 1
2 9 1
3 7 1
3 8 1
3 9 1
4 7 1
5 7 1
6 7 1
7 7 1
8 7 1
9 4 1
9 5 1
9 6 1
9 7 1
10 4 1
11 4 1
12 4 1
13 4 1
13 5 1
13 6 1
13 7 1
13 8 1
13 9 1
13 10 1
13 11 1
13 12 1
13 13 1
13 15 1
13 16 1
13 17 1
13 18 1
14 13 1
14 15 1
14 18 1
15 13 1
15 14 1
15 15 1
15 18 1
16 18 1
17 17 1
17 18 1
18 17 3
